"filename", "language", "JavaScript JSX", "CSS", "comment", "blank", "total"
"c:\Users\Lukáš Krejčí\Desktop\SKROZHOVICE\SkRozhovice---site\src\components\ADULT-subpages\AnimatedText.jsx", "JavaScript JSX", 60, 0, 1, 11, 72
"c:\Users\Lukáš Krejčí\Desktop\SKROZHOVICE\SkRozhovice---site\src\components\ADULT-subpages\EditModalPlayer.css", "CSS", 0, 79, 0, 13, 92
"c:\Users\Lukáš Krejčí\Desktop\SKROZHOVICE\SkRozhovice---site\src\components\ADULT-subpages\EditModalPlayer.jsx", "JavaScript JSX", 188, 0, 5, 18, 211
"c:\Users\Lukáš Krejčí\Desktop\SKROZHOVICE\SkRozhovice---site\src\components\ADULT-subpages\MainPageOld.css", "CSS", 0, 608, 1, 100, 709
"c:\Users\Lukáš Krejčí\Desktop\SKROZHOVICE\SkRozhovice---site\src\components\ADULT-subpages\MatchesTable.css", "CSS", 0, 239, 0, 60, 299
"c:\Users\Lukáš Krejčí\Desktop\SKROZHOVICE\SkRozhovice---site\src\components\ADULT-subpages\MatchesTable.jsx", "JavaScript JSX", 342, 0, 8, 30, 380
"c:\Users\Lukáš Krejčí\Desktop\SKROZHOVICE\SkRozhovice---site\src\components\ADULT-subpages\Nepoužívat - MainPageOld.jsx", "JavaScript JSX", 298, 0, 12, 39, 349
"c:\Users\Lukáš Krejčí\Desktop\SKROZHOVICE\SkRozhovice---site\src\components\ADULT-subpages\NewMainPageOld.jsx", "JavaScript JSX", 350, 0, 2, 42, 394
"c:\Users\Lukáš Krejčí\Desktop\SKROZHOVICE\SkRozhovice---site\src\components\ADULT\Adult.css", "CSS", 0, 72, 0, 14, 86
"c:\Users\Lukáš Krejčí\Desktop\SKROZHOVICE\SkRozhovice---site\src\components\ADULT\Adult.jsx", "JavaScript JSX", 33, 0, 1, 4, 38
"c:\Users\Lukáš Krejčí\Desktop\SKROZHOVICE\SkRozhovice---site\src\components\AKTUALITY\AddAktualita.jsx", "JavaScript JSX", 157, 0, 9, 30, 196
"c:\Users\Lukáš Krejčí\Desktop\SKROZHOVICE\SkRozhovice---site\src\components\AKTUALITY\AktualityMain.css", "CSS", 0, 703, 15, 146, 864
"c:\Users\Lukáš Krejčí\Desktop\SKROZHOVICE\SkRozhovice---site\src\components\AKTUALITY\AktualityMain.jsx", "JavaScript JSX", 280, 0, 7, 51, 338
"c:\Users\Lukáš Krejčí\Desktop\SKROZHOVICE\SkRozhovice---site\src\components\AKTUALITY\AktualityONE.jsx", "JavaScript JSX", 228, 0, 11, 46, 285
"c:\Users\Lukáš Krejčí\Desktop\SKROZHOVICE\SkRozhovice---site\src\components\AKTUALITY\DeleteAktualita.jsx", "JavaScript JSX", 31, 0, 2, 11, 44
"c:\Users\Lukáš Krejčí\Desktop\SKROZHOVICE\SkRozhovice---site\src\components\AKTUALITY\EditAktualita.jsx", "JavaScript JSX", 168, 0, 8, 29, 205
"c:\Users\Lukáš Krejčí\Desktop\SKROZHOVICE\SkRozhovice---site\src\components\BottomToTop.css", "CSS", 0, 42, 0, 6, 48
"c:\Users\Lukáš Krejčí\Desktop\SKROZHOVICE\SkRozhovice---site\src\components\BottomToTop.jsx", "JavaScript JSX", 36, 0, 4, 12, 52
"c:\Users\Lukáš Krejčí\Desktop\SKROZHOVICE\SkRozhovice---site\src\components\CookieConsentBanner.css", "CSS", 0, 70, 0, 12, 82
"c:\Users\Lukáš Krejčí\Desktop\SKROZHOVICE\SkRozhovice---site\src\components\CookieConsentBanner.jsx", "JavaScript JSX", 59, 0, 6, 20, 85
"c:\Users\Lukáš Krejčí\Desktop\SKROZHOVICE\SkRozhovice---site\src\components\Dropdown.css", "CSS", 0, 41, 0, 6, 47
"c:\Users\Lukáš Krejčí\Desktop\SKROZHOVICE\SkRozhovice---site\src\components\Dropdown.jsx", "JavaScript JSX", 24, 0, 1, 8, 33
"c:\Users\Lukáš Krejčí\Desktop\SKROZHOVICE\SkRozhovice---site\src\components\Footer.css", "CSS", 0, 115, 1, 22, 138
"c:\Users\Lukáš Krejčí\Desktop\SKROZHOVICE\SkRozhovice---site\src\components\Footer.jsx", "JavaScript JSX", 50, 0, 1, 3, 54
"c:\Users\Lukáš Krejčí\Desktop\SKROZHOVICE\SkRozhovice---site\src\components\HOME-page\Aktuality.css", "CSS", 0, 324, 1, 60, 385
"c:\Users\Lukáš Krejčí\Desktop\SKROZHOVICE\SkRozhovice---site\src\components\HOME-page\Aktuality.jsx", "JavaScript JSX", 68, 0, 2, 9, 79
"c:\Users\Lukáš Krejčí\Desktop\SKROZHOVICE\SkRozhovice---site\src\components\HOME-page\Contact.css", "CSS", 0, 77, 0, 14, 91
"c:\Users\Lukáš Krejčí\Desktop\SKROZHOVICE\SkRozhovice---site\src\components\HOME-page\Contact.jsx", "JavaScript JSX", 73, 0, 2, 9, 84
"c:\Users\Lukáš Krejčí\Desktop\SKROZHOVICE\SkRozhovice---site\src\components\HOME-page\LastMatch.css", "CSS", 0, 575, 2, 106, 683
"c:\Users\Lukáš Krejčí\Desktop\SKROZHOVICE\SkRozhovice---site\src\components\HOME-page\LastMatch.jsx", "JavaScript JSX", 217, 0, 2, 26, 245
"c:\Users\Lukáš Krejčí\Desktop\SKROZHOVICE\SkRozhovice---site\src\components\HOME-page\Map.css", "CSS", 0, 42, 0, 6, 48
"c:\Users\Lukáš Krejčí\Desktop\SKROZHOVICE\SkRozhovice---site\src\components\HOME-page\Map.jsx", "JavaScript JSX", 38, 0, 1, 8, 47
"c:\Users\Lukáš Krejčí\Desktop\SKROZHOVICE\SkRozhovice---site\src\components\HOME-page\OneAktualita.jsx", "JavaScript JSX", 38, 0, 2, 12, 52
"c:\Users\Lukáš Krejčí\Desktop\SKROZHOVICE\SkRozhovice---site\src\components\HOME-page\Sponsors.css", "CSS", 0, 53, 0, 9, 62
"c:\Users\Lukáš Krejčí\Desktop\SKROZHOVICE\SkRozhovice---site\src\components\HOME-page\Sponsors.jsx", "JavaScript JSX", 106, 0, 2, 11, 119
"c:\Users\Lukáš Krejčí\Desktop\SKROZHOVICE\SkRozhovice---site\src\components\HOME-page\TeamStats.css", "CSS", 0, 199, 0, 32, 231
"c:\Users\Lukáš Krejčí\Desktop\SKROZHOVICE\SkRozhovice---site\src\components\HOME-page\TeamStats.jsx", "JavaScript JSX", 127, 0, 2, 20, 149
"c:\Users\Lukáš Krejčí\Desktop\SKROZHOVICE\SkRozhovice---site\src\components\KONTAKT\ContactMain.css", "CSS", 0, 168, 0, 30, 198
"c:\Users\Lukáš Krejčí\Desktop\SKROZHOVICE\SkRozhovice---site\src\components\KONTAKT\ContactMain.jsx", "JavaScript JSX", 205, 0, 2, 26, 233
"c:\Users\Lukáš Krejčí\Desktop\SKROZHOVICE\SkRozhovice---site\src\components\KONTAKT\MapContact.jsx", "JavaScript JSX", 28, 0, 1, 8, 37
"c:\Users\Lukáš Krejčí\Desktop\SKROZHOVICE\SkRozhovice---site\src\components\KONTAKT\OneButton.css", "CSS", 0, 99, 0, 13, 112
"c:\Users\Lukáš Krejčí\Desktop\SKROZHOVICE\SkRozhovice---site\src\components\KONTAKT\OneButton.jsx", "JavaScript JSX", 21, 0, 1, 6, 28
"c:\Users\Lukáš Krejčí\Desktop\SKROZHOVICE\SkRozhovice---site\src\components\KONTAKT\OneTrainer.jsx", "JavaScript JSX", 15, 0, 1, 4, 20
"c:\Users\Lukáš Krejčí\Desktop\SKROZHOVICE\SkRozhovice---site\src\components\KONTAKT\SocialButton.jsx", "JavaScript JSX", 10, 0, 1, 4, 15
"c:\Users\Lukáš Krejčí\Desktop\SKROZHOVICE\SkRozhovice---site\src\components\LOGIN\LoginPage.css", "CSS", 0, 156, 0, 31, 187
"c:\Users\Lukáš Krejčí\Desktop\SKROZHOVICE\SkRozhovice---site\src\components\LOGIN\LoginPage.jsx", "JavaScript JSX", 157, 0, 8, 23, 188
"c:\Users\Lukáš Krejčí\Desktop\SKROZHOVICE\SkRozhovice---site\src\components\MainVideo.css", "CSS", 0, 57, 0, 9, 66
"c:\Users\Lukáš Krejčí\Desktop\SKROZHOVICE\SkRozhovice---site\src\components\MainVideo.jsx", "JavaScript JSX", 53, 0, 0, 9, 62
"c:\Users\Lukáš Krejčí\Desktop\SKROZHOVICE\SkRozhovice---site\src\components\NavItems.jsx", "JavaScript JSX", 78, 0, 1, 4, 83
"c:\Users\Lukáš Krejčí\Desktop\SKROZHOVICE\SkRozhovice---site\src\components\Navbar.css", "CSS", 0, 332, 0, 72, 404
"c:\Users\Lukáš Krejčí\Desktop\SKROZHOVICE\SkRozhovice---site\src\components\Navbar.jsx", "JavaScript JSX", 125, 0, 4, 21, 150
"c:\Users\Lukáš Krejčí\Desktop\SKROZHOVICE\SkRozhovice---site\src\components\OKlubu\AboutClub.css", "CSS", 0, 106, 0, 18, 124
"c:\Users\Lukáš Krejčí\Desktop\SKROZHOVICE\SkRozhovice---site\src\components\OKlubu\AboutClub.jsx", "JavaScript JSX", 89, 0, 1, 8, 98
"c:\Users\Lukáš Krejčí\Desktop\SKROZHOVICE\SkRozhovice---site\src\components\OKlubu\ButtonOrganization.jsx", "JavaScript JSX", 17, 0, 1, 5, 23
"c:\Users\Lukáš Krejčí\Desktop\SKROZHOVICE\SkRozhovice---site\src\components\OKlubu\FImages.jsx", "JavaScript JSX", 66, 0, 1, 7, 74
"c:\Users\Lukáš Krejčí\Desktop\SKROZHOVICE\SkRozhovice---site\src\components\OKlubu\FullGallery.css", "CSS", 0, 68, 0, 9, 77
"c:\Users\Lukáš Krejčí\Desktop\SKROZHOVICE\SkRozhovice---site\src\components\OKlubu\FullGallery.jsx", "JavaScript JSX", 40, 0, 4, 10, 54
"c:\Users\Lukáš Krejčí\Desktop\SKROZHOVICE\SkRozhovice---site\src\components\Overlay.jsx", "JavaScript JSX", 11, 0, 1, 4, 16
"c:\Users\Lukáš Krejčí\Desktop\SKROZHOVICE\SkRozhovice---site\src\components\ProtectedRoute.jsx", "JavaScript JSX", 10, 0, 1, 8, 19
"c:\Users\Lukáš Krejčí\Desktop\SKROZHOVICE\SkRozhovice---site\src\components\ScrollToTop.jsx", "JavaScript JSX", 17, 0, 1, 9, 27
"c:\Users\Lukáš Krejčí\Desktop\SKROZHOVICE\SkRozhovice---site\src\components\YOUNG-subpages\Gallery.css", "CSS", 0, 98, 0, 19, 117
"c:\Users\Lukáš Krejčí\Desktop\SKROZHOVICE\SkRozhovice---site\src\components\YOUNG-subpages\Gallery.jsx", "JavaScript JSX", 41, 0, 4, 11, 56
"c:\Users\Lukáš Krejčí\Desktop\SKROZHOVICE\SkRozhovice---site\src\components\YOUNG-subpages\MainPageY.css", "CSS", 0, 143, 0, 26, 169
"c:\Users\Lukáš Krejčí\Desktop\SKROZHOVICE\SkRozhovice---site\src\components\YOUNG-subpages\MainPageY.jsx", "JavaScript JSX", 73, 0, 1, 10, 84
"c:\Users\Lukáš Krejčí\Desktop\SKROZHOVICE\SkRozhovice---site\src\components\YOUNGERS\Young.css", "CSS", 0, 21, 0, 2, 23
"c:\Users\Lukáš Krejčí\Desktop\SKROZHOVICE\SkRozhovice---site\src\components\YOUNGERS\Young.jsx", "JavaScript JSX", 50, 0, 1, 6, 57
"c:\Users\Lukáš Krejčí\Desktop\SKROZHOVICE\SkRozhovice---site\src\components\YouthDropdown.jsx", "JavaScript JSX", 19, 0, 1, 6, 26
"Total", "-", 4096, 4487, 147, 1473, 10203